once -  как только	один раз
rich -  богатый
englishwoman -  англичанка
called -  называть	комм)вызывать	встр)созывать
mrs -  м|с
decided -  решать	определенный
have -  иметь	есть	позволять	х)уговаривать	уже
birthday -  день рождения
party -  партия	конт)экон)транс)сторона	встр)вечеринка
she -  она	у нее	ей
invited -  приглашать	приглашенный
lot -  партия	Р)масса	участок	много
and -  и
singer -  певец
the -  определенный артикль
was -  быть
poor -  бедный
but -  но	лишь
he -  он	у него	ему
had -  быть	х)уговаривать
very -  очень
good -  хорошо	хороший
voice -  высказывать	голос	речевой
house -  размещать	дом
at -  при	ат
exactly -  точно
six -  шесть	шести
as -  икак	как	так как	поскольку	1)по мере того как	столько	сколько	чем	такой же
been -  ъбыть
asked -  просить
do -  вделать
when -  при
went -  идти	Х)проходить
in -  в течение	
saw -  видеть
through -  через
door -  дверь	вход
that -  | что	й)| чтобы	это	и)то	этот	| что	| который	это
already -  уже
full -  полный	полностью
who -  кто	| который	кто
were -  месте
sitting -  сидеть	заседание
round -  округлять	круг	круглый
big -  большой	больше
table -  стол	инф)таблица	табличный
middle -  середина	средний
room -  размещать	комната
eating -  есть
laughing -  смеяться	смех	шуточный
talking -  говорить	болтовня	говорящий
him -  он
thought -  думать	мысль
going -  ходить	действующий
ask -  спрашивать	П)просить
join -  к	соединять	груп)объединять	соединение
them -  он	они
said -  сказать	вышеуказанный	говорят
glad -  радый
sir -  сэр
you -  ты	вы
come -  приходить	б)начинать
will -  быть	если	воля(завещание)
be -  быть	нужно	будь
singing -  петь	пение	поющий
after -  после	впоследствии	после того| как
dinner -  обед
call -  называть	звать	комм)вызывать	встр)созывать	Д)призывать	вызов	Д)призыв
soon -  скоро
ready -  готовый
listen -  слушать
now -  теперь
go -  ходить|пойти	Х)проходить
into -  на
kitchen -  кухня	кухонный
too -  слишком	тоже
please -  пожалуйста
angry -  сердитый
nothing -  ничто
first -  сначала	первый	первый
wanted -  хотеть	требующийся
leave -  оставлять	и)оставаться	уходить
then -  ззатем	затем	затем	тогда
his -  его	он	он
mind -  одуш)возражать	слушаться	обращать внимание	ум	мнение
stay -  оставаться	пребывание
teach -  учить
her -  ее	она	у нее	ей	она
lesson -  раздел	урок
having -  щиметь
joined -  соединять	груп)объединять
everybody -  каждый
well -  хорошо	хороший	колодец	геол)скважина
sing -  петь
my -  мой	я
some -  около
beautiful -  красивый
what -  что	какой	что	| который
are -  у
for -  для
